################
#..#......#....#
#..#..##..#..#.#
#..#..#...#..#.#
#..#..#...#..#.#
#..#..#...#..#.#
#..#..#...#..#.#
#..#..#...#..#.#
#S.#..#...#..#.#
#..#..#...#..#.#
#..#..##..#..#.#
#......#..#....#
################
