################
#S.......#.....#
###.####.#.###.#
#.....#..#...#.#
#.###.#.###.#..#
#.#...#...#.#..#
#.#.#####.#.#..#
#.#.....#.#.#..#
#.#.###.#.#.#..#
#...#...#...#..#
###.#.#####.##.#
#.....#.......#
################
