################
#.....#..#....S#
#.###.#..#.###.#
#.#.#.#..#.#...#
#.#.#.####.#.#.#
#...#......#.#.#
###.########.#.#
#...#......#.#.#
#.###.####.#.#.#
#.....#..#.#...#
#.#####..#.###.#
#........#.....#
################
